99
010101111
@11110010
000010111
010010010
1111#1111
010010010
010110000
010001110
011111011
